5/5/A
1001F/1010F/1010F/1010F/1100F/
0101F/1011F/1100F/1001F/0110F/
0101F/1101F/0101F/0101F/1101F/
0011F/0110F/0101F/0011F/0100F/
1011F/1010F/0010F/1010F/0100F/
S/2/2
