30/30/V
1101F/1001F/1010F/1010F/1010F/1000F/1010F/1110F/1001F/1100F/1011F/1010F/1000F/1010F/1110F/1001F/1000F/1100F/1001F/1010F/1010F/1100F/1001F/1010F/1100F/1001F/1100F/1011F/1010F/1100F/
0001F/0110F/1011F/1010F/1100F/0101F/1001F/1100F/0101F/0011F/1010F/1100F/0101F/1001F/1100F/0101F/0101F/0101F/0101F/1001F/1110F/0111F/0101T/1011F/0010F/0110F/0011F/1010F/1100F/0101F/
0101F/1001F/1100F/1001F/0100F/0101F/0101F/0101F/0011F/1010F/1100F/0101F/0011F/0100F/0011F/0110F/0101F/0111F/0011F/0100F/1001F/1010F/0110F/1001F/1100F/1001F/1010F/1100F/0011F/0100F/
0101F/0111F/0101T/0111F/0101F/0011F/0110F/0011F/1010F/1100F/0101F/0011F/1100F/0101F/1101F/1001F/0110F/1001F/1100F/0101F/0011F/1100F/1001F/0110F/0011F/0010F/1110F/0101F/1101F/0101F/
0101F/1001F/0110F/1101F/0101T/1101F/1001F/1010F/1100F/0111F/0101T/1011F/0110F/0011F/0100F/0011F/1010F/0110F/0101F/0101F/1101F/0011F/0110F/1001F/1010F/1100F/1001F/0110F/0001F/0110F/
0011F/0110F/1001F/0100F/0101F/0111F/0101T/1101F/0101F/1101F/0011F/1010F/1100F/1101F/0101T/1011F/1010F/1100F/0011F/0010F/0010F/1100F/1011F/0101T/1011F/0110F/0011F/1100F/0011F/1100F/
1011F/1010F/0100F/0101F/0011F/1100F/0101F/0101F/0011F/0100F/1001F/1110F/0101F/0111F/0011F/1010F/1010F/0100F/1001F/1010F/1100F/0011F/1010F/0100F/1001F/1010F/1000F/0110F/1011F/0100F/
1001F/1010F/0110F/0011F/1100F/0101F/0101F/0011F/1100F/0101F/0011F/1100F/0011F/1010T/1100F/1011F/1010F/0110F/0101F/1001F/0110F/1001F/1100F/0101F/0101F/1001F/0110F/1001F/1100F/0111F/
0001F/1010F/1010F/1100F/0111F/0011F/0110F/1001F/0110F/0011F/1010F/0100F/1001F/1110F/0011F/1100F/1001F/1010F/0110F/0101F/1011F/0110F/0101F/0101F/0101F/0101F/1001F/0110F/0011F/1100F/
0011F/1010F/1110F/0011F/1100F/1001F/1100F/0101F/1001F/1010F/1100F/0101F/0101F/1001F/1110F/0101F/0101F/1001F/1100F/0011F/1010F/1100F/0101F/0101F/0101F/0111F/0011F/1000F/1110F/0101F/
1001F/1100F/1001F/1010F/0110F/0101F/0101F/0101F/0011F/1110F/0101F/0101F/0101F/0011F/1100F/0011F/0110F/0101F/0101F/1001F/1100F/0101F/0011F/0110F/0011F/1000F/1100F/0101F/1001F/0100F/
0101F/0101F/0111F/1001F/1100F/0101F/0101F/0011F/1010F/1100F/0101F/0101F/0011F/1010F/0010F/1000F/1110F/0101F/0101F/0101F/0011F/0110F/1001F/1010F/1100F/0101F/0101F/0101F/0101F/0101F/
0101F/0011F/1010T/0110F/0011F/0110F/0011F/1010F/1100F/0011F/0110F/0011F/1010F/1010F/1100F/0111F/1001F/0110F/0101F/0101F/1001F/1010F/0110F/1001F/0110F/0101F/0101F/0101F/0101F/0111F/
0001F/1100F/1101F/1001F/1010F/1100F/1011F/1100F/0011F/1010F/1100F/1001F/1000F/1110F/0011F/1010F/0110F/1001F/0110F/0011F/0110F/1001F/1100F/0011F/1100F/0101F/0011F/0110F/0011F/1100F/
0111F/0101F/0001F/0110F/1101F/0101T/1011F/0100F/1001F/1010F/0110F/0101F/0011F/1100F/1001F/1010F/1110F/0101T/1101F/1011F/1000F/0110F/0111F/1001F/0110F/0001F/1110F/1001F/1100F/0101F/
1001F/0110F/0011F/1010F/0110F/0001F/1100F/0111F/0101F/1001F/1100F/0101F/1101F/0101F/0011F/1010F/1010F/0110F/0011F/1100F/0101F/1011F/1010F/0110F/1101F/0101F/1001F/0110F/0011F/0110F/
0101F/1001F/1100F/1001F/1100F/0111F/0011F/1010F/0100F/0111F/0011F/0010F/0110F/0001F/1010F/1010F/1100F/1011F/1100F/0101F/0011F/1010F/1100F/1001F/0010F/0110F/0101F/1011F/1000F/1100F/
0011F/0110F/0101F/0101F/0011F/1010T/1010F/1100F/0011F/1100F/1001F/1010F/1010F/0110F/1001F/1100F/0011F/1100F/0101F/0011F/1010F/1100F/0001F/0110F/1001F/1010F/0110F/1001F/0110F/0101F/
1011F/1100F/0011F/0110F/1001F/1110F/1001F/0110F/1011F/0010F/0110F/1101F/1001F/1010F/0110F/0011F/1010F/0110F/0011F/1000F/1100F/0101F/0011F/1110F/0101T/1011F/1010F/0110F/1001F/0110F/
1001F/0010F/1000F/1110F/0101F/1001F/0110F/1001F/1100F/1001F/1100F/0011F/0010F/1000F/1010F/1010F/1100F/1011F/1000F/0110F/0101F/0011F/1100F/1001F/0110F/1001F/1000F/1100F/0101F/1101F/
0011F/1100F/0111F/1001F/0110F/0101F/1001F/0110F/0101F/0101F/0011F/1100F/1011F/0110F/1001F/1100F/0011F/1100F/0101F/1101F/0101F/1001F/0110F/0011F/1100F/0111F/0101F/0101F/0101F/0101F/
1001F/0100F/1001F/0110F/1101F/0011F/0110F/1101F/0011F/0110F/1001F/0110F/1001F/1100F/0101F/0011F/1100F/0011F/0110F/0011F/0110F/0011F/1010F/1100F/0011F/1100F/0101F/0111F/0101F/0101F/
0101F/0111F/0011F/1010F/0100F/1011F/1000F/0100F/1001F/1110F/0011F/1010F/0110F/0011F/0110F/1101F/0011F/1010F/1100F/1001F/1010F/1100F/1101F/0101T/1011F/0110F/0011F/1100F/0011F/0100F/
0011F/1000F/1100F/1101F/0011F/1100F/0101F/0101F/0011F/1000F/1010F/1010F/1010F/1010F/1010F/0010F/1000F/1110F/0101F/0011F/1100F/0011F/0110F/0011F/1010F/1010F/1100F/0001F/1010F/0110F/
1001F/0110F/0011F/0100F/1101F/0101T/0111F/0101F/1001F/0110F/1001F/1010F/1010F/1010F/1010F/1100F/0111F/1001F/0010F/1110F/0011F/1010F/1100F/1001F/1010F/1100F/0101F/0011F/1100F/1101F/
0101F/1001F/1100F/0011F/0110F/0101F/1001F/0110F/0101F/1001F/0110F/1011F/1010F/1000F/1100F/0101F/1001F/0100F/1001F/1010F/1010F/1100F/0101F/0111F/1011F/0110F/0011F/1100F/0101F/0101F/
0001F/0110F/0011F/1100F/1001F/0110F/0101F/1011F/0110F/0011F/1010F/1010F/1100F/0111F/0001F/0010F/0110F/0111F/0101T/1011F/1100F/0101F/0101F/1001F/1010T/1100F/1001F/0110F/0101F/0101F/
0011F/1100F/1101F/0101F/0011F/1100F/0011F/1010F/1010T/1100F/1011F/1100F/0011F/1100F/0111F/1001F/1010F/1100F/0101F/1101F/0101F/0101F/0011F/0110F/1101F/0101F/0101F/1101F/0011F/0100F/
1101F/0011F/0100F/0001F/1110F/0011F/1010F/1100F/1101F/0011F/1100F/0011F/1100F/0011F/1100F/0101F/1001F/0110F/0101F/0001F/0110F/0011F/1000F/1010F/0110F/0011F/0110F/0001F/1100F/0101F/
0011F/1010F/0110F/0011F/1010F/1010F/1010F/0110F/0011F/1010F/0010F/1010F/0010F/1110F/0011F/0110F/0011F/1010F/0110F/0011F/1010F/1110F/0011F/1010F/1010F/1010F/1010F/0110F/0011F/0100F/
S/15/15
