5/5/C
1011F/1010F/1100F/1001F/1100F/
1001F/1100F/0011F/0110F/0101F/
0101F/0011F/1010F/1110F/0101F/
0011F/1100F/1001F/1010F/0100F/
1011F/0010F/0110F/1011F/0100F/
S/2/2
